###########
# .       #
#  $ $   .#
# @       #
###########