#########
#.   .  #
#$  $   #
#  @    #
#########