#########
#.   .  #
# $ $   #
#  @    #
#########