########
#  @  ##
#.*.$.##
#$*.$$##
# **$  #
#  ..$ #
#      #
########
Title: 3