  #########
  #       #
###+#$#$# #
# ..$   . #
# #$#  ####
# $    #
###.$#$#
  #. . #
  # #  #
  ######
Title: 4