##################
#############   ##
#  ##########    #
# $ ########## $ #
# $ ##  ##  ##   #
#   ########## $ #
#   #  . . .+# $ #
# $ #  # # # #   #
#  $#  . . ..##  #
#   #  # #  # #$ #
# #$   .....# #  #
#   #          $ #
#  $# ##### $# $ #
#                #
#     ######     #
#     ######     #
##################
Title: 5