     #####
     #   #
     # $ #
 ##### . #####
##   ## ##   ##
#  #    #  #  #
# .$**###*.$* #
#  #   #   #  #
##   # # #   ##
 ##**$. .$**##
## $ # # # $ ##
#  # $ # $ #  #
# . .*###*. . #
#  #  #    #  #
##   ## ##   ##
 #### # # ####
      # #
      # #
      # #
      # #
      # #
      # #
      # #
      # #
     # @ #
    #######
Title: Apple-tree