######
#. . #
##$$ #
#  @ # 
######